Improved Castle Tileset Palette 2
26 21
649 650 950 649 650 950 649 650 458 452 454 453 458 820 821 596 625 33 1006 33 1006
681 682 775 681 682 775 681 682 458 452 454 453 458 820 821 688 627 627 627 627 627
755 721 864 755 721 864 755 721 458 720 721 721 683 901 426 426 918 820 821 821 918
595 595 595 595 595 595 657 721 458 720 721 721 615 25 26 27 950 820 821 821 950
625 625 625 625 625 625 628 721 458 720 721 721 743 57 58 59 982 820 821 821 982
918 627 627 627 918 901 426 426 683 720 721 721 721 721 721 721 387 820 821 821 743
950 720 721 721 950 25 26 27 615 720 721 721 721 721 719 720 519 821 821 821 821
775 720 721 721 775 57 58 59 743 720 721 721 721 721 751 755 519 821 719 820 821
838 755 721 721 838 755 721 721 721 721 721 721 520 901 426 426 521 820 815 821 520
721 721 719 720 721 721 656 595 595 595 657 721 458 25 26 27 458 820 821 821 458
918 720 751 755 918 901 426 426 918 901 426 426 683 57 58 59 458 820 821 821 458
950 720 721 721 950 25 26 27 950 25 26 27 615 720 721 721 458 820 821 821 458
982 720 721 721 775 57 58 59 775 57 58 59 743 720 33 720 458 820 719 820 458
387 755 721 721 838 755 721 721 838 755 721 721 721 721 722 721 458 820 815 821 458
519 721 719 720 721 721 656 595 595 595 657 721 721 721 719 720 458 820 821 821 458
519 721 751 755 721 721 596 625 625 625 628 721 721 721 751 755 458 820 821 821 458
918 720 721 721 918 901 426 426 918 901 426 426 918 720 721 721 321 820 821 821 321
950 720 721 721 950 25 26 27 950 25 26 27 950 720 721 721 714 820 719 820 714
775 720 721 721 775 57 58 59 775 57 58 59 982 720 721 721 615 820 815 821 810
838 755 719 720 838 755 721 721 838 755 721 721 387 452 454 453 743 820 821 821 743
721 721 751 755 721 721 721 721 721 721 719 720 519 821 821 821 821 821 821 821 821
720 721 721 721 721 719 720 721 721 721 751 755 519 821 719 820 821 821 821 821 821
755 721 721 721 721 751 755 721 721 520 901 426 521 820 815 821 520 901 426 426 918
656 595 595 595 657 721 721 721 721 458 25 27 458 820 821 821 458 25 26 27 950
596 619 621 620 628 721 721 719 720 458 57 59 458 452 454 453 458 57 58 59 775
596 527 562 528 628 721 721 751 755 458 720 935 458 452 454 453 458 720 721 721 838
