FE8 - Fields - 01000203
19 22
814 946 849 751 624 783 676 684 653 783 857 858 859 711 559 587 419 618 586 587 545 583
849 775 688 140 141 720 228 676 98 720 889 890 891 684 685 495 424 460 779 524 456 586
783 686 98 113 38 135 141 98 783 98 921 922 923 76 77 559 424 592 804 495 587 545
752 424 497 102 111 167 173 98 98 98 98 395 140 72 73 141 751 624 98 559 525 424
583 456 492 497 784 785 98 640 98 266 324 293 172 172 166 103 720 98 720 98 495 456
545 583 545 465 720 98 98 676 772 298 299 782 138 741 773 467 98 782 98 783 559 587
456 551 424 492 497 98 743 98 228 676 741 773 677 229 228 676 467 784 785 98 98 559
619 418 618 492 465 752 424 497 720 498 499 140 78 141 782 228 676 139 720 208 261 206
619 422 492 492 615 523 456 465 711 782 743 172 166 38 71 782 640 171 641 467 292 333
678 454 429 492 583 417 584 545 497 752 424 497 720 113 38 77 676 139 170 770 720 396
582 587 545 492 586 520 419 618 586 524 456 492 497 168 38 137 228 676 677 229 98 292
545 583 424 492 779 525 424 492 779 525 587 545 496 108 38 81 720 498 499 70 135 141
456 551 424 496 804 559 746 592 783 559 525 424 496 98 102 114 109 98 98 113 38 38
587 419 618 592 206 720 98 903 904 905 559 424 592 98 782 98 98 784 785 172 166 38
559 622 592 783 366 367 783 935 936 937 816 751 98 140 141 720 98 98 807 808 809 172
814 881 785 98 238 206 720 967 872 969 848 946 70 38 169 98 98 783 839 840 841 880
849 98 98 98 98 292 327 324 293 783 140 134 38 38 109 98 98 98 871 872 873 912
134 135 141 98 98 266 357 299 98 98 172 104 38 169 98 98 816 817 98 292 327 267
167 110 113 109 266 391 299 98 783 98 720 106 47 107 720 98 784 881 785 98 298 299
